#LEMMINGS_TOTAL:10
#LEMMINGS_SALVAR:5
#TIEMPO_LIMITE:100
#ENTRADA:100,60
#SALIDA:700, 435
#ESCALADOR: 10
#PARAGUAS: 2
#BOMBA: 6
#BLOQUEADOR: 4
#MAPA

2222222222222222222222222
2222222221111111222222222
2000000000000000000000002
2000000000000000000000002
2111111111110000000000002
2111111111111000002222222
2000000000111110000112222
2000000000000111110000022
2000000000000000002222222
2000000022000000000000002
2222333322333111111333332
2000000000000000000000002
2200000000000000020000002
2211111000000000222000002
2111111000000002222200002
2222222233333332222222222