#LEMMINGS_TOTAL:10
#LEMMINGS_SALVAR:3
#TIEMPO_LIMITE:120
#ENTRADA:100,250
#SALIDA:600,435
#EXCAVADOR: 3
#PARAGUAS: 5
#BOMBA: 6
#BLOQUEADOR: 2
#MAPA

2222222222222222222222222
2222222221111111222222222
2000000000000000000000002
2000000000000000000000002
2000000000000000000000002
2111111111111111111110002
2111111111111111111110112
2000000000001111110010002
2000000000001111110111002
2022000000000000000000002
2111111111111111111111112
2000000000000000000000002
2200000000000000000000002
2200000000000000000000002
2111110000000000000000002
2222222223333222222222222