#LEMMINGS_TOTAL:10
#LEMMINGS_SALVAR:4
#TIEMPO_LIMITE:120
#ENTRADA:70,100
#SALIDA:90, 120
#EXCAVADOR: 2
#PARAGUAS: 10
#BOMBA: 2
#BLOQUEADOR: 2
#MAPA

2222222222222222222222222
2222222221111111222222222
2000000001111111110000002
2000000000000111000000002
2000000000000000000000002
2111111111111111111110002
2100011111111111111110112
2000000000001111110010002
2000000000001111110111002
2000000000000000000000002
2000011111111111111111112
2100000000000000000000002
2220000000000000000000002
2111000000000000000000002
2121220000000000000000002
2222222222222222222222222