#LEMMINGS_TOTAL:10
#LEMMINGS_SALVAR:4
#TIEMPO_LIMITE:100
#ENTRADA:50,100
#SALIDA:700, 145
#ESCALADOR: 10
#PARAGUAS: 10
#BOMBA: 2
#BLOQUEADOR: 2
#MAPA

2222222222222222222222222
2222222221111111222222222
2000000000000000000000002
2000000000000000000000002
2000000000000000000000002
2111111111100000000000002
2111111111100000000221112
2111110000000000000110002
2111110000000000000111002
2222120000000000000100002
2111111110000000000100002
2000000000000000000100332
2200000000000000000100112
2222220000000000000100002
2111110000000000000100002
2222222222222222222233332

