#LEMMINGS_TOTAL:10
#LEMMINGS_SALVAR:5
#TIEMPO_LIMITE:120
#ENTRADA:50,100
#SALIDA:700,435
#EXCAVADOR: 6
#PARAGUAS: 3
#BOMBA: 4
BLOQUEADOR: 4
#MAPA

2222222222222222222222222
2222222221111111222222222
2000000000000000000000002
2000000000000000000000002
2000000000000000000000002
2111111111100100000000002
2111111111110010000000112
2111110000001001000010002
2111110000000100100111002
2222120000000010010000002
2111111110000001001000002
2000000000000000100100002
2200000000000000010010002
2200000000000000001000002
2111110000000000000100002
2222222222222222222222222

