#LEMMINGS_TOTAL:10
#LEMMINGS_SALVAR:7
#TIEMPO_LIMITE:120
#ENTRADA:50,100
//600, 434
#SALIDA:50, 130
#EXCAVADOR: 2
#PARAGUAS: 2
#BOMBA: 2
BLOQUEADOR: 0
#MAPA

2222222222222222222222222
2222222221111111222222222
2000000001111111000000002
2000000000000000000000002
2000000000000000000000002
2111111111111111111110002
2111111111111111111110112
2000000000001111110010002
2000000000001111110111002
2000000000000000000000002
2000111111111111111111112
2100000000000000000000002
2220000000000000000000002
2111000000000000000000002
2121220000000000000000002
2222222222222222222222222