#LEMMINGS_TOTAL:10
#LEMMINGS_SALVAR:4
#TIEMPO_LIMITE:60
#ENTRADA:70,100
#SALIDA:500, 435
#ESCALADOR: 0
#PARAGUAS: 0
#BOMBA: 2
#BLOQUEADOR: 2
#MAPA

2222222222222222222222222
2222222221111111222222222
2000000001111111110000002
2000000000000111000000002
2000000000000000000000002
2111111111111111111111002
2100000000000000011111002
2000000000000000011111002
2111111111111113311111002
2000000000000000000000002
2333311111100011111111002
2100000000110000000000002
2220000000001000000000002
2111000000000100000000002
2121220000000000000000002
2222222222222222222222222