#LEMMINGS_TOTAL:10
#LEMMINGS_SALVAR:5
#TIEMPO_LIMITE:120
#ENTRADA:50,100
#SALIDA:500,435
#ESCALADOR: 6
#PARAGUAS: 10
#BOMBA: 0
#BLOQUEADOR: 2
#MAPA

2222222222222222222222222
2222222221111111222222222
2000000000000000000000002
2000000000000000000000002
2000000000000000000000002
2111111111100000000000002
2111111111100000000000112
2111110000000000000010002
2111110000000000000111002
2222120000000000000000002
2111111110000000000000002
2000000000000000000000002
2200000000000000000000002
2222220000000000000000002
2111110000000000000000002
2222222222222222233333332

