#LEMMINGS_TOTAL:10
#LEMMINGS_SALVAR:5
#TIEMPO_LIMITE:100
#ENTRADA:100,60
#SALIDA:100, 370
#ESCALADOR: 10
#PARAGUAS: 2
#BOMBA: 6
#BLOQUEADOR: 1
#MAPA

2222222222222222222222222
2222222221111111222222222
2000000000000000000000002
2000000000000000000000002
2111111111111110000000002
2111111111111111002222222
2111111111111111100112222
2000000000000000010000022
2000000000000000002222222
2022000022000000000000002
2111333311333311111111112
2000000000000000012222222
2200000000000000122222222
2211111000000001222222222
2111111000000012222222222
2222222222222222222222222