#LEMMINGS_TOTAL:10
#LEMMINGS_SALVAR:4
#TIEMPO_LIMITE:60
#ENTRADA:200,100
#SALIDA:150, 435
#ESCALADOR: 0
#PARAGUAS: 0
#BOMBA: 6
#BLOQUEADOR: 4
#MAPA

2222222222222222222222222
2222222221111111222222222
2000000001111111110000002
2000000000000000000000002
2000000000000000000000002
2001111111111111222222002
2000000000000000000000002
2001111111111111111111002
2000000000000000000000002
2000001111111111111331002
2000000000100000000000002
2000000001000000000000002
2000000010000000000000002
2000000100000000000000002
2000000000000000000000002
2333222222222222222223332